X X X X X X X X X X X X X X X X X X X X X X X X X X X X X
X X X X X X X X X X X X X X X X X X X X X X X X X X X X X
X X X X X X X X X X X X X X X X X X X X X X X X X X X X X
X X X X X X X X X X X X X X X X X X X X X X X X X X X X X
X b . + . + X X X X X X X X X X X X X X X X X + . + . y X
X . X X X . X X X X X X X X X X X X X X X X X . X X X . X
X * X X X + . + . + . + . + . P . + . + . + . + X X X * X
X . X X X . X X X . X X X X X X X X X . X X X . X X X . X
X + . + . + X X X + X X X X X X X X X + X X X + . + . + X
X X X X X . X X X . X X X X X X X X X . X X X . X X X X X
X X X X X + X X X + - n - - B - - n - + X X X + X X X X X
X X X X X . X X X X X | X X | X X | X X X X X . X X X X X
X X X X X + X X X X X F X X = X X F X X X X X + X X X X X
X X X X X . X X X X X | X X Y X X | X X X X X . X X X X X
X X X X X + X X X X X F X X I X X F X X X X X + X X X X X
X X X X X . X X X X X | X X C X X | X X X X X . X X X X X
< + . + . + . + . + . n X X X X X n . + . + . + . + . + >
X X X X X . X X X X X . X X X X X . X X X X X . X X X X X
X X X X X + X X X X X n - n - n - n X X X X X + X X X X X
X X X X X . X X X X X . X X X X X . X X X X X . X X X X X
X X X X X + X X X + . + X X X X X + . + X X X + X X X X X
X X X X X . X X X . X X X X X X X X X . X X X . X X X X X
X X X X X . X X X . X X X X X X X X X . X X X . X X X X X
X + . + . + X X X + X X X X X X X X X + X X X + . + . + X
X . X X X . X X X . X X X X X X X X X . X X X . X X X . X
X * X X X + . + . + . + . + . + . + . + . + . + X X X * X
X . X X X . X X X X X X X X X X X X X X X X X . X X X . X
X i . + . + X X X X X X X X X X X X X X X X X + . + . c X
X X X X X X X X X X X X X X X X X X X X X X X X X X X X X
X X X X X X X X X X X X X X X X X X X X X X X X X X X X X
X X X X X X X X X X X X X X X X X X X X X X X X X X X X X
X X X X X X X X X X X X X X X X X X X X X X X X X X X X X
