X X X X X X X X X X X X X X X X X X X X X X X X X X X X X X X X X X X X X X X X X X X X X X
X X X X X X X X X X X X X X X X X X X X X X X X X X X X X X X X X X X X X X X X X X X X X X
X X X X X X X X X X X X X X X X X X X X X X X X X X X X X X X X X X X X X X X X X X X X X X
X X X X X X X X X X X X X X X X X X X X X X X X X X X X X X X X X X X X X X X X X X X X X X
X X X X i . + . + . + . + . + . + . + . + . + . + . + . + . . + . + . + . + . . c X X X X X
X X X X . X X X X X X X X X X X . X X X . X X X X X X X . X X X X X X X X X X X . X X X X X
X X X X + X X X X X X X X X X X + X X X + X X X X X X X + X X X X X X X X X X X + X X X X X
X X X X . X X X X X X X X X X X . X X X . X X X X X X X . X X X X X X X X X X X . X X X X X
X X X X + X X X * . + . + . + . + X X X + . + . + X X X + . + . . + . + . * X X . X X X X X
X X X X . X X X X X X X X X X X . X X X X X X X . X X X . X X X X X X X X X X X + X X X X X
X X X X . X X X X X X X X X X X . X X X X X X X . X X X . X X X X X X X X X X X . X X X X X
X X b . + . + . + . + . + . + . + . + . + . + . + . + . B . + . . + . . + . + . + . . y X X
X X . X X X X X X X X X X X . X X X X X X X X X . X X X | X X X X . X X X X X X X X X . X X
X X + X X X X X X X X X X X + X X X X X X X X X . X X X = X X X X + X X X X X X X X X . X X
X X . X X X X X X X X X X X . X X X + . + . + . F X X X Y X X X X . X X X + . + . + . + X X
X X + . + . + X X X + . + . F X X X . X X X X X . X X X I X X X X . X X X X X X X X X . X X
X X . X X X . X X X . X X X . X X X + X X X X X + X X X C X X + . + X X X X X X X X X + X X
X X + X X X + X X X + X X X + X X X . X X X X X . X X X X X X X X . X X X X X X X X X . X X
X X . X X X . X X X . X X X . X X X + . + X X X F X X X + X X X X + X X X + . + . + . + X X
X X + X X X + X X X + X X X F X X X X X X X X X . X X X + X X X X . X X X X X X X X X . X X
X X . X X X . X X X . X X X . X X X X X X X X X . X X X . X X X X . X X X X X X X X X . X X
< . + . + . i . + . + . + . + . + . + . P . + . + . + . + . + . . + . . + . + . + . . c . >
X X . X X X X X X X X X X X X X X X . X X X . X X X . X X X X X X X X X X X X X X X X . X X
X X . X X X X X X X X X X X X X X X . X X X . X X X . X X X X X X X X X X X X X X X X . X X
X X + . + . + . + . * X X X + . + . + X X X + X X X + . + . + X X X X * . . + . + . . + X X
X X X X X X . X X X X X X X . X X X X X X X . X X X X X X X . X X X X X X X . X X X X X X X
X X X X X X + X X X X X X X + X X X X X X X + X X X X X X X + X X X X X X X + X X X X X X X
X X X X X X . X X X X X X X . X X X X X X X . X X X X X X X . X X X X X X X . X X X X X X X
X X X X X X b . + . + . + . + . + . + . + . + . + . + . + . + . . + . + . . y X X X X X X X
X X X X X X X X X X X X X X X X X X X X X X X X X X X X X X X X X X X X X X X X X X X X X X
X X X X X X X X X X X X X X X X X X X X X X X X X X X X X X X X X X X X X X X X X X X X X X
